00000000
01110100
00100010
01110100
00000000
00111100
00001000
00001000
00111100
00000000
